= Web.Contents("http://127.0.0.1:5000/predict", 
    [Query=[
        Age= Text.From([Age]), 
        BusinessTravel= [BusinessTravel], 
        DailyRate= Text.From([DailyRate]), 
        Department= [Department], 
        DistanceFromHome= Text.From([DistanceFromHome]), 
        Education= Text.From([Education]), 
        EducationField= [EducationField], 
        EmployeeCount= Text.From([EmployeeCount]), 
        EmployeeNumber= Text.From([EmployeeNumber]), 
        EnvironmentSatisfaction= Text.From([EnvironmentSatisfaction]), 
        Gender= [Gender], 
        HourlyRate= Text.From([HourlyRate]), 
        JobInvolvement= Text.From([JobInvolvement]), 
        JobLevel= Text.From([JobLevel]), 
        JobRole= [JobRole], 
        JobSatisfaction= Text.From([JobSatisfaction]), 
        MaritalStatus= [MaritalStatus], 
        MonthlyIncome= Text.From([MonthlyIncome]), 
        MonthlyRate= Text.From([MonthlyRate]), 
        NumCompaniesWorked= Text.From([NumCompaniesWorked]), 
        OverTime= [OverTime], 
        PercentSalaryHike= Text.From([PercentSalaryHike]), 
        PerformanceRating= Text.From([PerformanceRating]), 
        RelationshipSatisfaction= Text.From([RelationshipSatisfaction]), 
        StockOptionLevel= Text.From([StockOptionLevel]), 
        TotalWorkingYears= Text.From([TotalWorkingYears]), 
        TrainingTimesLastYear= Text.From([TrainingTimesLastYear]), 
        WorkLifeBalance= Text.From([WorkLifeBalance]), 
        YearsAtCompany= Text.From([YearsAtCompany]), 
        YearsInCurrentRole= Text.From([YearsInCurrentRole]), 
        YearsSinceLastPromotion= Text.From([YearsSinceLastPromotion]), 
        YearsWithCurrManager= Text.From([YearsWithCurrManager])
    ]])
